alive::dead
awake::asleep
artificial::natural
active::lazy
beautiful::ugly
big::small
bitter::sweet
brave::coward
best::worst
nude::dressed
cheap::expensive
clean::dirty
clever::idiot
cool::warm
cruel::humane
curly::straight
difficult::easy
delicious::awful
dirty::clear
same::different
good::bad
everyone::noone
everybody::nobody
someone::noone
early::late
fat::thin
first::last
angel::devil
dark::light
success::fail
fast::slow
full::empty
guilty::innocent
hard::soft
hell::heaven
huge::tiny
hot::cold
happy::sad
hardworking::lazy
junior::senior
modern::traditional
new::old
nice::nasty
intelligent::stupid
complex::simple
interesting::boring
light::heavy
long::short
legal::illegal
loud::quiet
polite::rude
poor::rich
quiet::noisy
major::minor
many::few
veteran::rookie
right::wrong
safe::dangerous
tiny::huge
small::big
soft::hard
single::married
true::false
well::ill
white::black
minimum::maximum
more::less
normal::strange
quick::speedy
poor::rich
private::public
amateur::professional
rude::polite
serious::funny
wet::dry
dead::alive
asleep::awake
natural::artificial
lazy::active
ugly::beautiful
small::big
sweet::bitter
coward::brave
worst::best
dressed::nude
expensive::cheap
dirty::clean
idiot::clever
warm::cool
humane::cruel
straight::curly
easy::difficult
awful::delicious
clear::dirty
different::same
bad::good
noone::everyone
nobody::everybody
noone::someone
late::early
thin::fat
last::first
devil::angel
light::dark
fail::success
slow::fast
empty::full
innocent::guilty
soft::hard
heaven::hell
tiny::huge
cold::hot
sad::happy
lazy::hardworking
senior::junior
traditional::modern
old::new
nasty::nice
stupid::intelligent
simple::complex
boring::interesting
heavy::light
short::long
illegal::legal
quiet::loud
rude::polite
rich::poor
noisy::quiet
minor::major
few::many
rookie::veteran
wrong::right
dangerous::safe
huge::tiny
big::small
hard::soft
married::single
false::true
ill::well
black::white
maximum::minimum
less::more
strange::normal
speedy::quick
rich::poor
public::private
professional::amateur
polite::rude
funny::serious
dry::wet